nnnnnnnn
nnsCeCnn
nnTPTTsn
nCTDDTCn
nsTTDTCn
nCTTTTTn
nnnCSTsn
nnnnnnnn