nnnnnnnn
nCTTCnnn
nCDTCCCn
nTTTCTTn
nTsCPDTn
nCSeTTTn
nnsSSSCn
nnnnnnnn