nnnnnnnn
nCTsCTCn
nTCTCssn
nTTDTDTn
nCPDCTCn
nDTTeSnn
nnCTSCnn
nnnnnnnn