nnnnnnnn
nCCTTTCC
nCTDCSTC
nSssCPCS
nCTTCTTS
nSTCCPTC
nTSTTTsS
nCCCeCTC