nnnnnnnn
nnCsCSCn
nCDCCTTn
nCPTCCTn
nnCCesSn
nSCTTDCn
nSCSTDSn
nnnnnnnn