nnnnnnnn
nCsSCTCn
nSTCCTsn
nCTTPCTn
nCDCDCen
nTTTDDTn
nsCsCTCn
nnnnnnnn