nnnnnnnn
nCsCeCnn
nCCDSDCn
nCTTCSSn
nCTTDPTn
nnCDTCsn
nnCsCTCn
nnnnnnnn