nnnnnnnn
nCTeCCnn
nTCTCSnn
nSTTCsnn
nsCsTTnn
nCSSTCnn
nnnnnnnn
nnnnnnnn