nnnnnnnn
nsSTeCnn
nTsCCCnn
nTTTTCnn
nCTTTsnn
nnsCCnnn
nnnnnnnn
nnnnnnnn