nnnnnnnn
nsTDSCnn
nSCDTTnn
nDPTSSnn
nCsCDTnn
nnCeTCnn
nnnnnnnn
nnnnnnnn