nnnnnnnn
nsCTCenn
nTTTPCnn
nCDCTTnn
nSsCTCnn
nCssSCnn
nnnnnnnn
nnnnnnnn