nnnnnnnn
nnCTSCnn
nCDTCSnn
nTDPeSnn
nSSsDsnn
nCTSsCnn
nnnnnnnn
nnnnnnnn