nnnnnnnn
nnCTTCnn
nCDDDCnn
nCPTDsnn
nTeSsTnn
nnCTSCnn
nnnnnnnn
nnnnnnnn