nnnnnnnn
nCCTsCnn
nTTDTCnn
neTDTsnn
nTTCSCnn
nCCTTsnn
nnnnnnnn
nnnnnnnn