nnnnnnnn
nCSTCnnn
nTTTSenn
nTDCSSnn
nsCsTTnn
nnsSTCnn
nnnnnnnn
nnnnnnnn