nnnnnnnn
nnCCnCnn
nCDDsSnn
nCDPCTnn
nTeTCsnn
nCsTSCnn
nnnnnnnn
nnnnnnnn