nnnnnnnn
nnCSCnnn
nesCCTnn
nTTDDsnn
nCTTDTnn
nCSsTCnn
nnnnnnnn
nnnnnnnn